"filename", "language", "TypeScript", "SCSS", "HTML", "comment", "blank", "total"
"c:\Users\Aurimas\Desktop\Bakalauras\TMSWebPage\src\app\Components\Internal management\Personal\competitions\competitions.component.html", "HTML", 0, 0, 65, 2, 19, 86
"c:\Users\Aurimas\Desktop\Bakalauras\TMSWebPage\src\app\Components\Internal management\Personal\competitions\competitions.component.scss", "SCSS", 0, 41, 0, 0, 9, 50
"c:\Users\Aurimas\Desktop\Bakalauras\TMSWebPage\src\app\Components\Internal management\Personal\competitions\competitions.component.spec.ts", "TypeScript", 20, 0, 0, 0, 6, 26
"c:\Users\Aurimas\Desktop\Bakalauras\TMSWebPage\src\app\Components\Internal management\Personal\competitions\competitions.component.ts", "TypeScript", 141, 0, 0, 0, 17, 158
"c:\Users\Aurimas\Desktop\Bakalauras\TMSWebPage\src\app\Components\Internal management\Personal\personal-best\personal-best.component.html", "HTML", 0, 0, 52, 0, 16, 68
"c:\Users\Aurimas\Desktop\Bakalauras\TMSWebPage\src\app\Components\Internal management\Personal\personal-best\personal-best.component.scss", "SCSS", 0, 21, 0, 0, 6, 27
"c:\Users\Aurimas\Desktop\Bakalauras\TMSWebPage\src\app\Components\Internal management\Personal\personal-best\personal-best.component.spec.ts", "TypeScript", 20, 0, 0, 0, 6, 26
"c:\Users\Aurimas\Desktop\Bakalauras\TMSWebPage\src\app\Components\Internal management\Personal\personal-best\personal-best.component.ts", "TypeScript", 131, 0, 0, 0, 15, 146
"c:\Users\Aurimas\Desktop\Bakalauras\TMSWebPage\src\app\Components\Internal management\Personal\personal-info\personal-info.component.html", "HTML", 0, 0, 129, 3, 16, 148
"c:\Users\Aurimas\Desktop\Bakalauras\TMSWebPage\src\app\Components\Internal management\Personal\personal-info\personal-info.component.scss", "SCSS", 0, 206, 0, 6, 32, 244
"c:\Users\Aurimas\Desktop\Bakalauras\TMSWebPage\src\app\Components\Internal management\Personal\personal-info\personal-info.component.spec.ts", "TypeScript", 20, 0, 0, 0, 6, 26
"c:\Users\Aurimas\Desktop\Bakalauras\TMSWebPage\src\app\Components\Internal management\Personal\personal-info\personal-info.component.ts", "TypeScript", 146, 0, 0, 0, 18, 164
"c:\Users\Aurimas\Desktop\Bakalauras\TMSWebPage\src\app\Components\Internal management\Personal\personal-stuff\personal-stuff.component.html", "HTML", 0, 0, 25, 3, 4, 32
"c:\Users\Aurimas\Desktop\Bakalauras\TMSWebPage\src\app\Components\Internal management\Personal\personal-stuff\personal-stuff.component.scss", "SCSS", 0, 49, 0, 32, 8, 89
"c:\Users\Aurimas\Desktop\Bakalauras\TMSWebPage\src\app\Components\Internal management\Personal\personal-stuff\personal-stuff.component.spec.ts", "TypeScript", 20, 0, 0, 0, 6, 26
"c:\Users\Aurimas\Desktop\Bakalauras\TMSWebPage\src\app\Components\Internal management\Personal\personal-stuff\personal-stuff.component.ts", "TypeScript", 64, 0, 0, 1, 9, 74
"c:\Users\Aurimas\Desktop\Bakalauras\TMSWebPage\src\app\Components\Internal management\UnauthenticatedUser\forgetpass\forgetpass.component.html", "HTML", 0, 0, 13, 0, 3, 16
"c:\Users\Aurimas\Desktop\Bakalauras\TMSWebPage\src\app\Components\Internal management\UnauthenticatedUser\forgetpass\forgetpass.component.scss", "SCSS", 0, 0, 0, 0, 1, 1
"c:\Users\Aurimas\Desktop\Bakalauras\TMSWebPage\src\app\Components\Internal management\UnauthenticatedUser\forgetpass\forgetpass.component.spec.ts", "TypeScript", 20, 0, 0, 0, 6, 26
"c:\Users\Aurimas\Desktop\Bakalauras\TMSWebPage\src\app\Components\Internal management\UnauthenticatedUser\forgetpass\forgetpass.component.ts", "TypeScript", 46, 0, 0, 1, 8, 55
"c:\Users\Aurimas\Desktop\Bakalauras\TMSWebPage\src\app\Components\Internal management\UnauthenticatedUser\login\LoginForm.ts", "TypeScript", 5, 0, 0, 0, 0, 5
"c:\Users\Aurimas\Desktop\Bakalauras\TMSWebPage\src\app\Components\Internal management\UnauthenticatedUser\login\TokenParams.ts", "TypeScript", 4, 0, 0, 0, 0, 4
"c:\Users\Aurimas\Desktop\Bakalauras\TMSWebPage\src\app\Components\Internal management\UnauthenticatedUser\login\login.component.html", "HTML", 0, 0, 33, 0, 3, 36
"c:\Users\Aurimas\Desktop\Bakalauras\TMSWebPage\src\app\Components\Internal management\UnauthenticatedUser\login\login.component.scss", "SCSS", 0, 0, 0, 0, 1, 1
"c:\Users\Aurimas\Desktop\Bakalauras\TMSWebPage\src\app\Components\Internal management\UnauthenticatedUser\login\login.component.spec.ts", "TypeScript", 20, 0, 0, 0, 6, 26
"c:\Users\Aurimas\Desktop\Bakalauras\TMSWebPage\src\app\Components\Internal management\UnauthenticatedUser\login\login.component.ts", "TypeScript", 107, 0, 0, 6, 13, 126
"c:\Users\Aurimas\Desktop\Bakalauras\TMSWebPage\src\app\Components\Internal management\UnauthenticatedUser\register\RegisterForm.ts", "TypeScript", 8, 0, 0, 0, 0, 8
"c:\Users\Aurimas\Desktop\Bakalauras\TMSWebPage\src\app\Components\Internal management\UnauthenticatedUser\register\register.component.html", "HTML", 0, 0, 47, 0, 10, 57
"c:\Users\Aurimas\Desktop\Bakalauras\TMSWebPage\src\app\Components\Internal management\UnauthenticatedUser\register\register.component.scss", "SCSS", 0, 5, 0, 4, 0, 9
"c:\Users\Aurimas\Desktop\Bakalauras\TMSWebPage\src\app\Components\Internal management\UnauthenticatedUser\register\register.component.spec.ts", "TypeScript", 20, 0, 0, 0, 6, 26
"c:\Users\Aurimas\Desktop\Bakalauras\TMSWebPage\src\app\Components\Internal management\UnauthenticatedUser\register\register.component.ts", "TypeScript", 73, 0, 0, 2, 13, 88
"c:\Users\Aurimas\Desktop\Bakalauras\TMSWebPage\src\app\Components\Internal management\UnauthenticatedUser\user.component.html", "HTML", 0, 0, 23, 0, 15, 38
"c:\Users\Aurimas\Desktop\Bakalauras\TMSWebPage\src\app\Components\Internal management\UnauthenticatedUser\user.component.scss", "SCSS", 0, 22, 0, 1, 5, 28
"c:\Users\Aurimas\Desktop\Bakalauras\TMSWebPage\src\app\Components\Internal management\UnauthenticatedUser\user.component.spec.ts", "TypeScript", 20, 0, 0, 0, 6, 26
"c:\Users\Aurimas\Desktop\Bakalauras\TMSWebPage\src\app\Components\Internal management\UnauthenticatedUser\user.component.ts", "TypeScript", 38, 0, 0, 0, 9, 47
"c:\Users\Aurimas\Desktop\Bakalauras\TMSWebPage\src\app\Components\Internal management\adminside\adminside.component.html", "HTML", 0, 0, 104, 4, 29, 137
"c:\Users\Aurimas\Desktop\Bakalauras\TMSWebPage\src\app\Components\Internal management\adminside\adminside.component.scss", "SCSS", 0, 103, 0, 5, 14, 122
"c:\Users\Aurimas\Desktop\Bakalauras\TMSWebPage\src\app\Components\Internal management\adminside\adminside.component.spec.ts", "TypeScript", 20, 0, 0, 0, 6, 26
"c:\Users\Aurimas\Desktop\Bakalauras\TMSWebPage\src\app\Components\Internal management\adminside\adminside.component.ts", "TypeScript", 115, 0, 0, 1, 19, 135
"c:\Users\Aurimas\Desktop\Bakalauras\TMSWebPage\src\app\Components\Internal management\invitations\invitations.component.html", "HTML", 0, 0, 29, 0, 9, 38
"c:\Users\Aurimas\Desktop\Bakalauras\TMSWebPage\src\app\Components\Internal management\invitations\invitations.component.scss", "SCSS", 0, 82, 0, 4, 16, 102
"c:\Users\Aurimas\Desktop\Bakalauras\TMSWebPage\src\app\Components\Internal management\invitations\invitations.component.spec.ts", "TypeScript", 20, 0, 0, 0, 6, 26
"c:\Users\Aurimas\Desktop\Bakalauras\TMSWebPage\src\app\Components\Internal management\invitations\invitations.component.ts", "TypeScript", 79, 0, 0, 0, 14, 93
"c:\Users\Aurimas\Desktop\Bakalauras\TMSWebPage\src\app\Components\Modals\athlete-list\athlete-list.component.html", "HTML", 0, 0, 138, 0, 27, 165
"c:\Users\Aurimas\Desktop\Bakalauras\TMSWebPage\src\app\Components\Modals\athlete-list\athlete-list.component.scss", "SCSS", 0, 84, 0, 0, 14, 98
"c:\Users\Aurimas\Desktop\Bakalauras\TMSWebPage\src\app\Components\Modals\athlete-list\athlete-list.component.spec.ts", "TypeScript", 20, 0, 0, 0, 6, 26
"c:\Users\Aurimas\Desktop\Bakalauras\TMSWebPage\src\app\Components\Modals\athlete-list\athlete-list.component.ts", "TypeScript", 178, 0, 0, 3, 31, 212
"c:\Users\Aurimas\Desktop\Bakalauras\TMSWebPage\src\app\Components\Modals\coach-training-assign-modal\coach-training-assign-modal.component.html", "HTML", 0, 0, 64, 0, 7, 71
"c:\Users\Aurimas\Desktop\Bakalauras\TMSWebPage\src\app\Components\Modals\coach-training-assign-modal\coach-training-assign-modal.component.scss", "SCSS", 0, 88, 0, 4, 15, 107
"c:\Users\Aurimas\Desktop\Bakalauras\TMSWebPage\src\app\Components\Modals\coach-training-assign-modal\coach-training-assign-modal.component.spec.ts", "TypeScript", 20, 0, 0, 0, 6, 26
"c:\Users\Aurimas\Desktop\Bakalauras\TMSWebPage\src\app\Components\Modals\coach-training-assign-modal\coach-training-assign-modal.component.ts", "TypeScript", 96, 0, 0, 0, 20, 116
"c:\Users\Aurimas\Desktop\Bakalauras\TMSWebPage\src\app\Components\Modals\new-competition-modal\new-competition-modal.component.html", "HTML", 0, 0, 54, 0, 6, 60
"c:\Users\Aurimas\Desktop\Bakalauras\TMSWebPage\src\app\Components\Modals\new-competition-modal\new-competition-modal.component.scss", "SCSS", 0, 51, 0, 2, 6, 59
"c:\Users\Aurimas\Desktop\Bakalauras\TMSWebPage\src\app\Components\Modals\new-competition-modal\new-competition-modal.component.spec.ts", "TypeScript", 20, 0, 0, 0, 6, 26
"c:\Users\Aurimas\Desktop\Bakalauras\TMSWebPage\src\app\Components\Modals\new-competition-modal\new-competition-modal.component.ts", "TypeScript", 53, 0, 0, 0, 12, 65
"c:\Users\Aurimas\Desktop\Bakalauras\TMSWebPage\src\app\Components\Modals\personal-training-modal\personal-training-modal.component.html", "HTML", 0, 0, 144, 0, 19, 163
"c:\Users\Aurimas\Desktop\Bakalauras\TMSWebPage\src\app\Components\Modals\personal-training-modal\personal-training-modal.component.scss", "SCSS", 0, 84, 0, 0, 14, 98
"c:\Users\Aurimas\Desktop\Bakalauras\TMSWebPage\src\app\Components\Modals\personal-training-modal\personal-training-modal.component.spec.ts", "TypeScript", 20, 0, 0, 0, 6, 26
"c:\Users\Aurimas\Desktop\Bakalauras\TMSWebPage\src\app\Components\Modals\personal-training-modal\personal-training-modal.component.ts", "TypeScript", 158, 0, 0, 2, 29, 189
"c:\Users\Aurimas\Desktop\Bakalauras\TMSWebPage\src\app\Components\Training Management\home\home.component.html", "HTML", 0, 0, 101, 4, 30, 135
"c:\Users\Aurimas\Desktop\Bakalauras\TMSWebPage\src\app\Components\Training Management\home\home.component.scss", "SCSS", 0, 174, 0, 6, 32, 212
"c:\Users\Aurimas\Desktop\Bakalauras\TMSWebPage\src\app\Components\Training Management\home\home.component.spec.ts", "TypeScript", 20, 0, 0, 0, 6, 26
"c:\Users\Aurimas\Desktop\Bakalauras\TMSWebPage\src\app\Components\Training Management\home\home.component.ts", "TypeScript", 208, 0, 0, 12, 36, 256
"c:\Users\Aurimas\Desktop\Bakalauras\TMSWebPage\src\app\Components\Training Management\training-templates\training-templates.component.html", "HTML", 0, 0, 268, 10, 40, 318
"c:\Users\Aurimas\Desktop\Bakalauras\TMSWebPage\src\app\Components\Training Management\training-templates\training-templates.component.scss", "SCSS", 0, 315, 0, 8, 44, 367
"c:\Users\Aurimas\Desktop\Bakalauras\TMSWebPage\src\app\Components\Training Management\training-templates\training-templates.component.spec.ts", "TypeScript", 20, 0, 0, 0, 6, 26
"c:\Users\Aurimas\Desktop\Bakalauras\TMSWebPage\src\app\Components\Training Management\training-templates\training-templates.component.ts", "TypeScript", 276, 0, 0, 1, 52, 329
"c:\Users\Aurimas\Desktop\Bakalauras\TMSWebPage\src\app\Components\nav-bar\nav-bar.component.html", "HTML", 0, 0, 54, 0, 6, 60
"c:\Users\Aurimas\Desktop\Bakalauras\TMSWebPage\src\app\Components\nav-bar\nav-bar.component.scss", "SCSS", 0, 65, 0, 0, 10, 75
"c:\Users\Aurimas\Desktop\Bakalauras\TMSWebPage\src\app\Components\nav-bar\nav-bar.component.spec.ts", "TypeScript", 20, 0, 0, 0, 6, 26
"c:\Users\Aurimas\Desktop\Bakalauras\TMSWebPage\src\app\Components\nav-bar\nav-bar.component.ts", "TypeScript", 87, 0, 0, 1, 13, 101
"c:\Users\Aurimas\Desktop\Bakalauras\TMSWebPage\src\app\Interfaces\IAthlete.ts", "TypeScript", 5, 0, 0, 0, 2, 7
"c:\Users\Aurimas\Desktop\Bakalauras\TMSWebPage\src\app\Interfaces\IAthleteForm.ts", "TypeScript", 9, 0, 0, 0, 1, 10
"c:\Users\Aurimas\Desktop\Bakalauras\TMSWebPage\src\app\Interfaces\ICoachAssignedTraining.ts", "TypeScript", 7, 0, 0, 0, 1, 8
"c:\Users\Aurimas\Desktop\Bakalauras\TMSWebPage\src\app\Interfaces\ICompetition.ts", "TypeScript", 7, 0, 0, 0, 0, 7
"c:\Users\Aurimas\Desktop\Bakalauras\TMSWebPage\src\app\Interfaces\IPersonalTraining.ts", "TypeScript", 18, 0, 0, 0, 1, 19
"c:\Users\Aurimas\Desktop\Bakalauras\TMSWebPage\src\app\Interfaces\IPersonalTrainingFew.ts", "TypeScript", 16, 0, 0, 0, 2, 18
"c:\Users\Aurimas\Desktop\Bakalauras\TMSWebPage\src\app\Interfaces\IRecords.ts", "TypeScript", 11, 0, 0, 0, 2, 13
"c:\Users\Aurimas\Desktop\Bakalauras\TMSWebPage\src\app\Interfaces\ISet.ts", "TypeScript", 5, 0, 0, 0, 0, 5
"c:\Users\Aurimas\Desktop\Bakalauras\TMSWebPage\src\app\Interfaces\ISetFull.ts", "TypeScript", 7, 0, 0, 0, 0, 7
"c:\Users\Aurimas\Desktop\Bakalauras\TMSWebPage\src\app\Interfaces\ISetToDisplay.ts", "TypeScript", 5, 0, 0, 0, 1, 6
"c:\Users\Aurimas\Desktop\Bakalauras\TMSWebPage\src\app\Interfaces\ITime.ts", "TypeScript", 4, 0, 0, 0, 0, 4
"c:\Users\Aurimas\Desktop\Bakalauras\TMSWebPage\src\app\Interfaces\ITrainingDefinition.ts", "TypeScript", 4, 0, 0, 0, 1, 5
"c:\Users\Aurimas\Desktop\Bakalauras\TMSWebPage\src\app\Interfaces\ITrainingTemplate.ts", "TypeScript", 16, 0, 0, 0, 0, 16
"c:\Users\Aurimas\Desktop\Bakalauras\TMSWebPage\src\app\Interfaces\IUser.ts", "TypeScript", 9, 0, 0, 0, 2, 11
"c:\Users\Aurimas\Desktop\Bakalauras\TMSWebPage\src\app\app-routing.module.ts", "TypeScript", 35, 0, 0, 0, 4, 39
"c:\Users\Aurimas\Desktop\Bakalauras\TMSWebPage\src\app\app.component.html", "HTML", 0, 0, 4, 0, 4, 8
"c:\Users\Aurimas\Desktop\Bakalauras\TMSWebPage\src\app\app.component.scss", "SCSS", 0, 9, 0, 0, 3, 12
"c:\Users\Aurimas\Desktop\Bakalauras\TMSWebPage\src\app\app.component.spec.ts", "TypeScript", 31, 0, 0, 0, 5, 36
"c:\Users\Aurimas\Desktop\Bakalauras\TMSWebPage\src\app\app.component.ts", "TypeScript", 9, 0, 0, 0, 2, 11
"c:\Users\Aurimas\Desktop\Bakalauras\TMSWebPage\src\app\app.module.ts", "TypeScript", 82, 0, 0, 0, 7, 89
"c:\Users\Aurimas\Desktop\Bakalauras\TMSWebPage\src\app\services\API\admin.service.spec.ts", "TypeScript", 12, 0, 0, 0, 5, 17
"c:\Users\Aurimas\Desktop\Bakalauras\TMSWebPage\src\app\services\API\admin.service.ts", "TypeScript", 41, 0, 0, 0, 10, 51
"c:\Users\Aurimas\Desktop\Bakalauras\TMSWebPage\src\app\services\API\auth.service.spec.ts", "TypeScript", 12, 0, 0, 0, 5, 17
"c:\Users\Aurimas\Desktop\Bakalauras\TMSWebPage\src\app\services\API\auth.service.ts", "TypeScript", 50, 0, 0, 3, 14, 67
"c:\Users\Aurimas\Desktop\Bakalauras\TMSWebPage\src\app\services\API\http.service.spec.ts", "TypeScript", 12, 0, 0, 0, 5, 17
"c:\Users\Aurimas\Desktop\Bakalauras\TMSWebPage\src\app\services\API\personalmanagement.service.spec.ts", "TypeScript", 12, 0, 0, 0, 5, 17
"c:\Users\Aurimas\Desktop\Bakalauras\TMSWebPage\src\app\services\API\personalmanagement.service.ts", "TypeScript", 129, 0, 0, 2, 25, 156
"c:\Users\Aurimas\Desktop\Bakalauras\TMSWebPage\src\app\services\API\personaltrainings.service.spec.ts", "TypeScript", 12, 0, 0, 0, 5, 17
"c:\Users\Aurimas\Desktop\Bakalauras\TMSWebPage\src\app\services\API\personaltrainings.service.ts", "TypeScript", 97, 0, 0, 0, 16, 113
"c:\Users\Aurimas\Desktop\Bakalauras\TMSWebPage\src\app\services\API\templatetrainings.service.spec.ts", "TypeScript", 12, 0, 0, 0, 5, 17
"c:\Users\Aurimas\Desktop\Bakalauras\TMSWebPage\src\app\services\API\templatetrainings.service.ts", "TypeScript", 65, 0, 0, 0, 10, 75
"c:\Users\Aurimas\Desktop\Bakalauras\TMSWebPage\src\app\services\helper\helper.service.spec.ts", "TypeScript", 12, 0, 0, 0, 5, 17
"c:\Users\Aurimas\Desktop\Bakalauras\TMSWebPage\src\app\services\helper\helper.service.ts", "TypeScript", 39, 0, 0, 0, 6, 45
"Total", "-", 3138, 1399, 1347, 133, 1070, 7087